#####
#@$.#
#####
;
 ########
##      #
#   .   #
#   $   #
# .$@$. #
#   $ ###
#   . ##
#      #
########
;
#######
#     #
#  $$ #
# $ $@#
#..####
#..#   
####  
;
  #####
  #.  #
###   #
# $*$ #
#   ###
#@ .#  
#####  
;
########
#     .#
#   $$@#
#  #  .#
########
;
#######
#    .#
#  $$.#
#  # @#
#######
;
########
#     .#
#  $$ @#
#  #  .#
########
;
########
#   #  #
#     .#
# $$  @#
# #   .#
########
;
#######
#     #
#    .#
#@$$$.#
#  # .#
#######
;
#######
#   . #
# $$@ #
#  #  #
#    .#
#######
;
######
#   .#
# $$@#
#  # #
#.   #
######
;
######
# @ .#
# $$ #
#  #.#
#    #
######
;
######
#   .#
# $$@#
#  # #
# .  #
######
;
 #####
##@ .#
# $$.#
#    #
######
;
######
#   .#
# $$ #
# @###
##.#  
 ###  
;
######
# @ .#
# $$ #
#  # #
#   .#
######
;
#######
#  $ .#
#  @$ #
#  #$.#
#  . ##
###### 
;
######
# @ .#
# $$ #
#  # #
##.  #
 #####
;
#######
#    .#
# $$#.#
# $@ .#
#     #
#######
;
########
#     .#
# @$$$.#
#  #  .#
########
;
#######
#     #
#    .#
#@$$$.#
#  # .#
#######
;
#######
#    .#
#@$$$.#
#   #.#
#######
;
######
# @$.#
#    #
# $#.#
#    #
######
;
########
#   # .#
#   $$@#
####   #
   #  .#
   #####
;
########
#@  # .#
# $  $ #
####   #
   #  .#
   #####
;
 #####
##  .#
# $$ #
# @.##
##### 
